jevil
25 15
8 8
16 10
12
0 0
1 1
2 2
3 3
4 2
5 2
6 2
7 2
8 2
9 2
10 2
11 2
0 0 0 0 0 8 4 4 4 4 4 4 4 4 4 4 4 4 4 9 0 0 0 0 0 
0 0 0 0 0 5 1 1 1 1 1 1 1 1 1 1 1 1 1 6 0 0 0 0 0 
0 0 0 0 0 5 1 1 1 1 1 1 1 1 1 1 1 1 1 6 0 0 0 0 0 
0 0 0 0 0 5 1 1 1 1 1 1 1 1 1 1 1 1 1 6 0 0 0 0 0 
0 0 0 0 0 5 1 1 1 1 1 1 1 1 1 1 1 1 1 6 0 0 0 0 0 
0 0 0 0 0 5 1 1 1 1 3 3 3 3 3 1 1 1 1 6 0 0 0 0 0 
0 0 0 0 0 5 1 1 1 1 1 1 1 1 1 1 1 1 1 6 0 0 0 0 0 
0 0 0 0 0 5 1 1 1 1 1 1 1 1 1 1 1 1 1 6 0 0 0 0 0 
0 0 0 0 0 5 3 3 3 1 1 1 1 1 1 1 3 3 3 6 0 0 0 0 0 
0 0 0 0 0 5 1 1 1 1 1 1 1 1 1 1 1 1 1 6 0 0 0 0 0 
0 0 0 0 0 5 1 1 1 1 1 1 1 1 1 1 1 1 1 6 0 0 0 0 0 
0 0 0 0 0 5 1 1 1 1 3 3 3 3 3 1 1 1 1 6 0 0 0 0 0 
0 0 0 0 0 5 1 1 1 1 1 1 1 1 1 1 1 1 1 6 0 0 0 0 0 
0 0 0 0 0 5 1 1 1 1 1 1 1 1 1 1 1 1 1 6 0 0 0 0 0 
0 0 0 0 0 10 7 7 7 7 7 7 7 7 7 7 7 7 7 11 0 0 0 0 0 
