test
25 15
8 8
16 10
10
0 2
1 2
2 1
3 1
4 2
5 2
6 2
7 2
8 2
9 0
0 1 0 1 0 1 0 1 0 1 0 1 0 1 0 1 0 1 0 1 0 1 0 1 0
1 0 1 0 1 0 1 0 1 0 1 0 1 0 1 0 1 0 1 0 1 0 1 0 1
0 1 0 1 0 2 2 2 2 2 2 2 2 2 2 2 2 2 2 2 0 1 0 1 0
1 0 1 0 1 3 3 3 3 3 3 3 3 3 3 3 3 3 3 3 1 0 1 0 1
0 1 0 1 0 3 3 3 3 3 3 3 3 3 3 3 3 3 3 3 0 1 0 1 0
1 0 1 0 1 3 3 3 3 3 3 3 3 3 3 3 3 3 3 3 1 0 1 0 1
0 1 0 1 0 3 3 3 3 3 3 3 3 3 3 3 3 3 3 3 0 1 0 1 0
1 0 1 0 1 3 3 3 3 3 3 3 3 3 3 3 3 3 3 3 1 0 1 0 1
0 1 0 1 0 3 3 3 3 3 3 3 3 3 3 3 3 3 3 3 0 1 0 1 0
1 0 1 0 1 3 3 3 3 3 3 3 3 3 3 3 3 3 3 3 1 0 1 0 1
0 1 0 1 5 5 6 7 6 7 3 3 3 3 3 3 3 3 3 3 0 1 0 1 0
1 0 1 0 1 0 8 7 8 7 3 3 3 3 3 3 3 3 3 3 1 0 1 0 1
0 1 0 1 0 1 5 5 5 5 5 5 5 5 5 5 5 5 5 5 0 1 0 1 0
1 0 1 0 1 0 1 0 1 0 1 0 1 0 1 0 1 0 1 0 1 0 1 0 1
0 1 0 1 0 1 0 1 0 1 0 1 0 1 0 1 0 1 0 1 0 1 0 1 0
1 0 1 0 1 0 1 0 1 0 1 0 1 0 1 0 1 0 1 0 1 0 1 0 1
