whispy
25 15
7 13
16 11
6
0 0
1 1
2 6
3 5
4 5
5 5
2 2 2 2 5 3 1 1 1 1 1 1 1 1 1 1 1 1 1 4 5 2 2 2 2 
2 2 2 2 5 3 1 1 1 1 1 1 1 1 1 1 1 1 1 4 5 2 2 2 2
2 2 2 2 5 3 1 1 1 1 1 1 1 1 1 1 1 1 1 4 5 2 2 2 2 
2 2 2 2 5 3 1 1 1 1 1 1 1 1 1 1 1 1 1 4 5 2 2 2 2 
2 2 2 2 5 3 1 1 1 1 1 1 1 1 1 1 1 1 1 4 5 2 2 2 2 
2 2 2 2 5 3 1 1 1 1 1 1 1 1 1 1 1 1 1 4 5 2 2 2 2 
2 2 2 2 5 3 1 1 1 1 1 1 1 1 1 1 1 1 1 4 5 2 2 2 2 
2 2 2 2 5 3 1 1 1 1 1 1 1 1 1 1 1 1 1 4 5 2 2 2 2 
2 2 2 2 5 3 1 1 1 1 1 1 1 1 1 1 1 1 1 4 5 2 2 2 2 
2 2 2 2 5 3 1 1 1 1 1 1 1 1 1 1 1 1 1 4 5 2 2 2 2 
2 2 2 2 5 3 1 1 1 1 1 1 1 1 1 1 1 1 1 4 5 2 2 2 2
2 2 2 2 5 3 1 1 1 1 1 1 1 1 1 1 1 1 1 4 5 2 2 2 2
2 2 2 2 5 3 1 1 1 1 1 1 1 1 1 1 1 1 1 4 5 2 2 2 2
2 2 2 2 2 0 0 0 0 0 0 0 0 0 0 0 0 0 0 0 2 2 2 2 2
2 2 2 2 2 0 0 0 0 0 0 0 0 0 0 0 0 0 0 0 2 2 2 2 2
